                                      ###########                               
                                      #.........#   ##########                  
        ##########                    #.........#   #........#                  
        #........#                    #.........#   #........#                  
        #........#                    #.........#   #........# #################
        #........#                    #.........#   #........# #...............#
        ####..####          ###########.........#   ####..######...............#
           #..#             #...................#      #.......................#
           #..#             #...................#   ##########.................#
           #..#             #.....@.............#   #..........................#
        ####..#####         #...................#####................#####.....#
        #.........#   #######........................................#   #.....#
        #.........#   #..............................................#####.....#
        #.........#####........................................................#
#####   #.......................................################################
#...#####.......................................#                               
#.................######################........#                               
#...#####.........#                    #........#                               
#####   #.........#                    #........#                               
        ###########                    #........#                               
                                       #........#                              
                                       #........#                               
                                       #........#                               
                                       ##########                              

