                                                                                |
                                                                                |
                           #####                                                |
                          ##...##                                               |
                          #..T..#                                               |
                          ###.###                                               |
                            #.#                                                 |
                        #####/#####                                             |
                        #.........#                                             |
                        #....@....#                                             |
                        #.........#                                             |
       #.#              ####..#####      ########                               |
       #.#                 #..#          #......#                               |
       #.#                 #..#          #......#                               |
       #.#           #######..######     #......#                               |
       #.#           #.............#     #......#                               |
       #.#############.............#######......#                               |
       #........................................#                               |
       ###############.............#######......#                               |
                     #.............#     #......#                               |
                     ########/######     #......#                               |
                            #.#          #......#                               |
                            #.#          ########                               |
                            #2#                                                 |

