################################################################################
#............#..................................#............#.................#
#............#.#................................#............#.................#
#............#.#................................#............#.................#
#............#.#................................#............#.................#
#............#.#................................#.############.................#
#............#.#................................#.#............................#
#..............#................................#.#.##########.................#
################..................@.............#...#..........................#
#...............................................#####..........................#
#...............................................#..............................#
#.....................#########.................#..............................#
#.............................#.................#..............................#
#.............................#.................#####################..........#
#.............................#.....................................#..........#
#.....................##################............................#..........#
#.....................#................#............................#..........#
#.....................#................#............................#..........#
#.....................#................#............................#..........#
#.....................#................#.......................................#
#.....................#................#.......................................#
#.....................#................#.......................................#
#.....................#........................................................#
################################################################################

