                                                                                
                                                                                
        ##########                    ###########       #####                   
        #........######################.........#   #####...##                  
        #.......................................#   #........#     #############
        #........######################.........#   #........#     #...........#
        ####..####                    #.........#   ####..##########...........#
           #..#             ###########.........#      #.......................#
           #..#             #...................#   ####.......................#
           #..#             #.....@.............#   #..........................#
        ####..#####         #...................#####................#####.....#
        #.........#   #######........................................#   #.....#
        #.........#   #..............................................#####.....#
        #.........#####........................................................#
#####   #.......................................################################
#...#####.......................................#                               
#.................######################........#  #############                
#...#####.........#                    #........#  #...........#                
#####   #.........#                    #........####......####.#                
        ###########                    #..................####.#                
                                       #.......................#               
                                       #........####......######                
                                       #........#  #......#                     
                                       ##########  ########                    

